XXXXXXXXXXXXXXX
X________X____X
X____X___XXX__X
XXXX_XXX______X
X______X______X
X______X______X
XXXX_XXXXXXXXXX
X______X______X
XX_XXXXX______X
X______X______X
XXXXXX_XXXXXX_X
X______X______X
X______X______X
X_____________X
XXXXXXXXXXXXXXX
UUUUUUIIIUUUUUU
